1111111111111
100001C000001
1010011100001
1E1P000001C01
1111111111111
