111111111111111111111
100000000000000000001
101011111111111111101
101000C000B0000001E01
1010111111000000B0001
1000000001001111111B1
101110000100000000001
1C0000000000011111111
10B0000P00000000000C1
111111111111111111111
