1111111111111111111
1000000000C00000001
1000011111110000001
1000001B00001110001
1000011000000010001
10001C000B000001001
1000000011110000101
1000010000011100001
1E000000P000000C001
1111111111111111111
