111111111111111111111
1P00000C0000100000001
100001111111010111111
1000001000000100000001
1011101000000111111001
1000101000011100001001
100010100000000B010001
1000101111100000110001
1000100000B0000001001
1000C0000000000011001
111111111111111111111
