1111111111111111111111
1P00000000000000000001
1111011111111101111111
1000010001000010000001
1011101001101010000011
1000001001001010111001
1000C0010010001000001
1011111001000100110001
1000000000B000C0000001
1001111110001111111111
1000B00000000000000001
1111111111111111111111
