1111111111111
1000B10000B01
1010011100001
1E1P000001001
1111111111111
