1111111111111
1000B1C000B01
1110011100001
1E1P000001C01
1111111111111
